NO ./textures/redbrick.xpm
SO ./textures/wood.xpm
WE ./textures/greystone.xpm
EA ./textures/bluestone.xpm


C 125,0,0
F 220,100,0

111111111111111111111
100000000000000000001
111110000111111111101
101000000100000010001
100000000001000010001
110100011111001110001
100000000000000000001
111111111111111111111