NO ./textures/redbrick.xpm
SO ./textures/wood.xpm
WE ./textures/greystone.xpm
EA ./textures/bluestone.xpm


C 125,0,0
F 220,100,0

11111111111111111111111
1000000000000000000000011111
11111000011111111101111
101000N00100000110001111
100000000001000010001
11110001111100111000111111
1000000000000000000001
111111111111111111111111