NO ./textures/redbrick.xpm
SO ./textures/wood.xpm
WE ./textures/greystone.xpm
EA ./textures/bluestone.xpm


C 125,0,0
F 220,100,0

11111111111111111111111
10100000101000000000011111
11111000011111111101111
101000000100000100001011
1000000000010E00100011
11110001011100111000111111
1000000010000000000001
1111111111111111111111111111111111