NO ./textures/redbrick.xpm
SO ./textures/wood.xpm
WE ./textures/greystone.xpm
EA ./textures/bluestone.xpm


C 125,0,0
F 220,100,0

     111111111111111111111     1
   1110000000100000000000011  101
  101110000111111110111100011  1
 10000000010000000001000000011
 100000000001E0010100000011101       1
 10110001011001110001111000111      101   
 10000000000000000001   110001       1
 12111111111111211111111111121
 1011       1110111       1101
1001         10001         1001   1
1001        1100011        1001  101
 1001     11100000011     1001    1
  121111111000000000111111121
 10000000100111111100000000001
 10000000001  111  10000000001
  111111000011100111000001111
       110000000000000011
        11010101010101011
         101010101010101
         11 1 1 1 1 1 11